11111111111111111111111111111111
1111111111111111111...........P1
1111111111111111111............1
1.U.....................11111111
1.......................11111111
111111111111111................1
111111111111111................1
1...................111111111111
1...................111111111111
1.......................11111111
111111111...............1...U..1
1.......111.............1......1
1.....U...1.............111111.1
1...1.....1....................1
1....11111.....................1
1.......1......................1
1.......1........U.............1
1.......1......................1
1.......11111..................1
1.........................U....1
1..............................1
1........................1111111
1........................1111111
11111111111111111111111111111111